暧	abbe
晕	abkq
晖	abkq
时	adi
颢	afmbo
旷	ai
昽	aikp
晓	ajpu
昙	ammi
旸	ansh
题	aombo
晔	aopj
韪	aoqs
鹍	appym
显	atc
鹛	aupym
垦	avg
恳	avp
鹖	avpym
腽	babt
幂	bakb
胆	bam
髅	bbfdv
觅	bbhu
髌	bbjoc
髋	bbjtu
爱	bbke
册	bbm
鹏	bbpm
鹘	bbpym
髇	bbyrb
脱	bcru
腾	bfqm
脚	bgil
脓	bhbv
胜	bhqm
见	bhu
臜	bhuo
脏	big
胧	bikp
脉	bine
悬	bip
腻	bipo
膑	bjoc
冈	bk	b'k
胨	bkd
网	bkk	b'kk
刚	bkln
军	bkq
胁	bksc
肿	bl
县	bmi
删	bmln
腼	bmwl	bmw'l
胫	bnom
肠	bnsh
贝	bo
赗	boabu
赐	boaph
赒	bobgr	bob'gr
赑	boboo
赠	bocwa
财	bodh
赕	boff
贩	bohe
赂	boher
贬	bohio
赙	boibi
赃	boig
贼	boij
贱	boij
赇	boije
贻	boir
赌	bojka
贮	bojm
赎	bojnk
贿	bokb
则	boln
脍	bomi
脸	bomm
赈	bommv
赋	bompm
赡	boncr
罂	booju
败	book
赊	boomf
购	bopi
账	bopo
贶	borhu
赆	bosoy
赚	botxc
婴	bov
贴	boyr
赔	boytr
赅	boyvo
胀	bpo
皲	bqdhe
郓	bqnl
肤	bqo
脶	brob
腭	brrs
睐	budt
飖	buhnk	buhn'k
眬	buikp
瞆	bulmo
觃	bund
睁	bunsd
睑	buomm
鹞	bupym
瞩	bushb
眍	busk	bus'k
瞒	butmb
鹦	bvpym
腘	bwmi	bw'mi
胶	byck
肮	byhn
脐	bykl
胪	bys
写	bysm
脑	byuk	byu'k
錚	cbsd
颁	chmbo
鹈	chpym
颂	cimbo
郸	cjnl
冁	cjstv
爷	cksl
鹟	cmpym
錚	cnsd
鋳	cqki
兑	crhu
总	crp
鹆	crpym
贫	csho
单	cwj
兽	cwmr
栅	dbbm
枧	dbhu
樱	dbov
枣	dby
椫	dcwj
梦	ddni	ddn'i
权	de
树	dedi
柽	deg
颇	dembo
榉	dfcq
楼	dfdv
档	dfsm	dfs'm
樯	dgcw
桥	dhkl
栀	dhmu
机	dhn
枫	dhnk	dhn'k
栎	dhvd
桩	dig
栈	dij
椮	dikh
栊	dikp
檪	diod
槠	diva
柠	djmn
椟	djnk
槟	djoc
桡	djpu
栋	dkd
槛	dlit
榄	dliu
赖	dlnbo
榈	dlsr
栖	dmcw
枥	dmks
标	dmmf
橱	dmmi
桠	dmtc
槚	dmwo
极	dnhe
椭	dnlb
杨	dnsh
杩	dnvm
橹	dnwa
桧	domi
检	domm
枞	doo
桦	dopj
枪	dosu
构	dpi
枨	dpo
梼	dqki
枢	dsk	ds'k
棂	dsmf
来	dt
赉	dtbo
横	dtlc
栏	dtmm
样	dtq
栉	dtsl
桤	dusu
橼	dvmo
椤	dwln
桢	dybo
梿	dykq
椁	dyrd
栌	dys
榇	dytd
檩	dywf
温	eabt
灏	eafo
湿	eatc
艰	eav
观	ebhu
浑	ebkq
溅	eboj
测	ebon
懑	ebp
泪	ebu
泻	ebym
对	edi
濑	edlo
颡	edmbo
涞	edt
汉	ee
双	ee
叠	eeem
滩	eeog
泽	eeq
溇	efdv
圣	eg
洁	egr
浓	ehbv
涤	ehed
烫	ehf
滗	ehhu
没	ehne
沨	ehnk	ehn'k
鲨	ehnwm
沪	ehs
泺	ehvd
戏	ei
浅	eij
渗	eikh
泷	eikp
沩	eiks
怼	eip
沪	eis
泼	eive
浒	eivj
渖	ejll
泞	ejmn
渎	ejnk
滨	ejoc
浇	ejpu
潴	ekha
渐	ekql
劝	eks
浃	ekt
渊	elfl
滥	elit
浊	elmi
溃	elmo
涧	elsa
润	elsg
澜	elsw
洒	emcw
沥	emks
鸿	empm
涣	enbk
邓	enl
渌	enme
滪	enno
欢	eno
泾	enom
涨	enpo
浄	ensd
汤	ensh
澛	enwa
渔	enwm
溆	eode
难	eog
浍	eomi
潋	eomk
沦	eop
沧	eosu
沟	epi
鸡	epym
沣	eqj
滟	eqju
涛	eqki
渍	eqmo
潜	eqoa
涢	erbo
渑	erlu
涡	erob
汇	es
涩	esim
滠	esje
沤	esk	es'k
浔	esmi
浕	esoy
潆	etbf
滢	etbi
涝	etbs
滞	etjb
潇	etll
满	etmb
颒	etmbo
汹	euk	eu'k
潍	evmg
涠	ewqs	ew'qs
浈	eybo
滦	eycd
湾	eycn
滚	eycv
濒	eyho
济	eykl
浏	eykn
涟	eykq
滤	eypp
泸	eys
浐	eyth
觉	fbbhu
喾	fbhgr
尝	fbmmi
学	fbnd
鲎	fbnwm
鹡	fbpym
鸴	fbpym
赏	fbrbo
党	fbrhu
黉	fbtlc
举	fcq
挙	fcq
誉	fcymr
粮	fdiav
糁	fdikh
类	fdk
粝	fdmms
糇	fdonk
粪	fdtc
娄	fdv
颣	ffmbo
尘	fg
炉	fhs
烁	fhvd
炉	fis
烧	fjpu
鳖	fknwm
炼	fkvc
炼	fkvd
烛	flmi
焖	flsp
烦	fmbo
兴	fmc
灯	fmn
焕	fnbk
烃	fnom
炀	fnsh
烩	fomi
烨	fopj
炝	fosu
鲞	fqnwm
炜	fqs
誊	fqymr
炽	frc
当	fsm	fs'm
烬	fsoy
烂	ftmm
灿	fu
辉	fubkq
数	fvok
烟	fwk	fw'k
埘	gadi
声	gah
壳	gbhn
悫	gbhp
壸	gbmc
坝	gbo
埩	gbsd
壶	gbtc
丧	gcv
啬	gcwr	gcw'r
赪	gcybo
块	gdk
墙	ggcw
圹	gi
垅	gikp
却	gisl
坏	gmf
坜	gmks
坛	gmmi
垭	gmtc
埩	gnsd
场	gnsh
趱	gohuo
赵	gok
赶	gomj
趋	gonsm	gons'm
坞	gpvm
毂	gqhne
埙	grbo
颉	grmbo
埚	grob
垲	gusu
盐	gybt
坟	gyk
垆	gys
垴	gyuk	gyu'k
皑	hausu
笕	hbhu
奥	hbk
农	hbv
箪	hcwj
税	hdcru
释	hdeq
穑	hdgcw
秾	hdhbv
秃	hdhn
种	hdl
籁	hdlo
秆	hdmj
称	hdnf
稳	hdnsp
穞	hdnwa
积	hdrc
秽	hduni	hdun'i
条	hed
务	heks
处	heo
备	hew
惫	hewp
处	hey
篓	hfdv
鹙	hfpym
筜	hfsm
丢	hgi
贸	hhbo
须	hhmbo
笔	hhqu
躯	hhsk	hhs'k
笺	hij
笼	hikp
魉	himob
鹅	hipym
鸱	hipym
质	hjbo
鹎	hjpym
乔	hkll
蚕	hklmi
岙	hku
币	hlb
篮	hlit
筛	hllb
箫	hlll
颀	hlmbo
篑	hlmo
简	hlsa
毁	hmhne
惩	hmp
飓	hnbmc
凤	hne	hn'e
飚	hnfff
飗	hnhhw
飕	hnhxe
风	hnk	hn'k
颓	hnmbo
箓	hnme
飏	hnnsh
飑	hnpru
躗	hnryo
筝	hnsd
笃	hnvm
飔	hnwp
飐	hnyr
徕	hodt
签	homm
鸻	homnm
酂	honl
径	honom
衔	hoopn
篯	hopj
彻	hopsh
媭	hov
筚	hppj
箨	hqeq
牦	hqhqu
犊	hqjnk
筹	hqki
牺	hqmcw
箦	hqmo
筼	hrbo
敌	hrok
鹄	hrpym
鸹	hrpym
乱	hru
辞	hrytj
笋	hsk
箧	hskt	hs'kt
启	hsr
衅	htfq
赞	hubo
氇	hunwa
毡	huyr
鼹	hvajv
乐	hvd
簖	hvdl
箓	hvne
囱	hwhe
箩	hwln
粤	hwmvs
囱	hwni	hw'ni
鹠	hwpym
舆	hxkc
舰	hybhu
盘	hybt
舣	hyik
笾	hyks
舱	hyosu
鸼	hypym
篱	hyub
舻	hyys
贠	ibo
术	id
书	ids
视	ifbhu
禅	ifcwj
应	ifm
祢	ifnf
禄	ifnme
祃	ifnvm
鹧	ifpym
祷	ifqki
祎	ifqs
祦	ifrmk
祸	ifrob
祦	ifrvk
礼	ifu
祯	ifybo
毵	ihhqu
庐	ihs
垒	iiig
庞	iikp
庐	iis
废	iive
戋	ij
盏	ijbt
刬	ijln
义	ik
庆	ik
参	ikhhh
飙	ikhnk	ikhn'k
龙	ikp
库	ikq
为	iksi	iks'i
赓	iloo
庙	ilw
决	imdk
减	imihr
冻	imkd
庑	imku
冲	iml
净	imnsd
冯	imnvm
凑	imqkk
况	imrhu
凉	imyrf
凛	imywf
邝	inl
讠	inv
资	iobo
盗	iobt
楽	iod
鹰	iogm
鹒	iopym
垄	ipg
贰	ipmmo
庼	ipmo
砻	ipmr
鸢	ippym
聋	ipsj
龚	iptc
袭	ipyhv
詟	ipymr
户	is
启	isr
谒	ivapv
谩	ivawe
调	ivbgr	ivb'gr
诨	ivbkq
诅	ivbm
谖	ivbme
谣	ivbou
诇	ivbr	ivb'r
讼	ivci
说	ivcru
诐	ivdhe
讨	ivdi
诀	ivdk
谏	ivdwf	ivdw'f
译	iveq
诮	ivfb
谠	ivfbu
谈	ivff
诗	ivgdi
诖	ivgg
诘	ivgr
诱	ivhds
诿	ivhdv
诰	ivhgr
诜	ivhgu
谢	ivhhi
诛	ivhjd
话	ivhjr
诟	ivhmr
诉	ivhmy
讥	ivhn
设	ivhne
讽	ivhnk	ivhn'k
讬	ivhp
诋	ivhvi
谀	ivhxo
诚	ivihs
议	ivik
诶	iviok
谘	ivior
试	ivipm
诒	ivir
谝	ivisb
诫	ivit
计	ivj
谳	ivjbk
谊	ivjbm
诧	ivjhp
诸	ivjka
谉	ivjll
读	ivjnk
诂	ivjr
发	ivke
诙	ivkf
诳	ivkhg
训	ivlll
诽	ivlmy
谰	ivlsw
讧	ivm
评	ivmfj
讦	ivmj
语	ivmmr
订	ivmn
诃	ivmnr
诬	ivmoo
诼	ivmso
谮	ivmua
讶	ivmvh
谭	ivmwj
证	ivmym
谵	ivncr
谲	ivnhb
谄	ivnhx
诵	ivnib
讯	ivnj
诞	ivnkv
诡	ivnmu
谞	ivnob
诤	ivnsd
诌	ivnsm	ivns'm
谗	ivnuy
认	ivo
讷	ivob
谁	ivog
谯	ivogf
诊	ivohh
谶	ivoim
谂	ivoip
许	ivoj
诠	ivomg
谕	ivomn
讫	ivon
论	ivop
讹	ivop
诈	ivos
诲	ivowy
询	ivpa
诣	ivpa
谧	ivpht
谐	ivppa
谍	ivptd
诔	ivqd
诪	ivqki
请	ivqmb
讳	ivqs
识	ivrc
误	ivrmk
谔	ivrrs
讱	ivshi
诏	ivshr
诹	ivsje
讴	ivsk	ivs'k
诓	ivsmg	ivs'mg
谬	ivsmh
诩	ivsmm
词	ivsmr
讵	ivss
记	ivsu
谟	ivtak
谫	ivtbh
谱	ivtca
谥	ivtct
诺	ivtkr
谨	ivtlm
谋	ivtmd
谌	ivtmv
详	ivtq
讲	ivtt
谦	ivtxc
谎	ivtyu
讪	ivu
讻	ivuk
诎	ivuu
谓	ivwb
谡	ivwce
课	ivwd
讣	ivy
谛	ivybb
谤	ivybs
谪	ivycb
谜	ivyfd
谚	ivyhh
访	ivyhs
谴	ivylr
让	ivym
谇	ivyoj
谑	ivypm
谆	ivyrd
谅	ivyrf
谙	ivyta
该	ivyvo
廪	iywf
赍	jbbo
献	jbik
窭	jcfdv
窦	jcjnk
穷	jcks
窜	jcll
颠	jcmbo
窍	jcmms
窑	jcoju
窃	jcpsh
窎	jcpym
窥	jcqou
窝	jcrob
鹁	jdpym
灾	jf
宪	jhgu
宠	jikp
载	jikq
韩	jjqs
觌	jkbhu
协	jksc
寝	jlme
审	jlwl
宝	jmgi
卖	jnyk
宾	jomc
尧	jpmu
鹕	jrbpm
额	jrmbo
鸪	jrpym
宫	jrr
贲	jtbo
宽	jtbu
骞	jtcm
赛	jtco
鹓	jupym
翘	jusmm
实	jyk
橥	kad
牵	kbhq
瘿	kbov
痈	kbq	kb'q
瘅	kcwj
东	kd
杀	kd
夺	kdi
弑	kdipm
刹	kdln
癞	kdlo
鸫	kdpym
瘫	keog
瘘	kfdv
鹩	kfpym
狈	khbo
獭	khdlo
犷	khi
犹	khiku
狱	khivk
猪	khjka
狞	khjmn
狭	khkt
狮	khllb
独	khlmi
狲	khndf
狝	khnf
疯	khnk	khn'k
猕	khnnf
狰	khnsd
犸	khnvm
狯	khomi
猃	khomm
猎	khta
猫	khtw
瘪	khup
猬	khwb
猡	khwln
瘆	kikh
态	kip
癫	kjco
瘗	kktg
暂	kla
錾	klc
椠	kld
堑	klg
痫	klsd
疬	kmks
疴	kmnr
疠	kms
痖	kmtc
痪	knbk
杂	knd
瘾	knlp
癣	knmq
疗	knn
痉	knom
鸠	knpym
疡	knsh
疮	kosu
疱	kpru
车	kq
辒	kqabt
辊	kqapp
辋	kqbtv	kqb'tv
轰	kqee
辍	kqeee
辚	kqfdq
辕	kqgrv
辀	kqhby
辂	kqher
轷	kqhfd
轿	kqhkl
斩	kqhml
轶	kqhqo
轹	kqhvd
辅	kqijb
轼	kqipm
辘	kqixp
辖	kqjqr
轱	kqjr
轪	kqk
轨	kqkn
轴	kqlw
轾	kqmig
轩	kqmj
轲	kqmnr
辆	kqmob
辐	kqmrw
轭	kqmsu
软	kqno
轻	kqnom
轸	kqohh
辁	kqomg
输	kqomn
轮	kqop
辏	kqqkk
转	kqqni
轵	kqrc
辑	kqrsj
轫	kqshi
轺	kqshr
辄	kqsju
辗	kqstv
轧	kqu
辎	kqvvw
辙	kqybk
较	kqyck
辌	kqyrf
轳	kqys
贺	krbo
驾	krnvm
办	ksc
奁	ksk	ks'k
疖	ksl
疟	ksm
夹	kt
痨	ktbs
頬	ktmbc
颊	ktmbo
郏	ktnl
尴	kulit
鹌	kupym
奋	kw
痹	kwml
旧	la
裈	lbkq
帐	lbpo
帱	lbqki
帻	lbqmo
帏	lbqs
帜	lbrc
帼	lbwmi	lbw'mi
帧	lbybo
衬	ldi
袜	ldj
鹇	ldpym
隶	le
肾	leb
贤	lebo
坚	leg
紧	levif
竖	leyt
褛	lfdv
裆	lfsm	lfs'm
装	lgyhv
袄	lhk
览	libhu
蚬	libhu
监	libt
蛊	libt
鉴	lic
蜕	licru
蝉	licwj
蛏	lieg
蝼	lifdv
虮	lihn
蚝	lihqu
蚁	liik
蛲	lijpu
奨	lik
裤	likq
蛱	likt
蛳	lillb
螀	lilmi
丬	lim
醤	limcw
蛎	limms
虾	limy
蚂	linvm
蝇	lirlu
蜗	lirob
门	lis
蜡	lita
蝾	litbd
蟏	litll
螨	litmb
虬	liu
袯	live
蝈	liwmi	liw'mi
蛴	liykl
鸯	lkpym
肃	llfl
褴	llit
牍	lljnk
帅	lllb
顺	lllo
师	llmb
畅	llnsh
临	lloa
鹔	llpym
裥	llsa
归	llsm	lls'm
襕	llsw
贵	lmbo
壮	lmg
虫	lmi
状	lmik
将	lmnii
妆	lmv
费	lnbo
桨	lnd
浆	lne
牍	lnjnk
奖	lnk
酱	lnmcw
裣	lomm
袆	lqs
间	lsa
阊	lsaa
阘	lsasm
阌	lsbbe
阒	lsbuk
阅	lscru
阐	lscwj
闲	lsd
闭	lsdh
阑	lsdwf	lsdw'f
阔	lsehr
闺	lsgg
阖	lsgit
阁	lsher
阍	lshpa
阋	lshxu
阆	lsiav
阈	lsirm
阗	lsjbc
阇	lsjka
闳	lski
阉	lsklu
闽	lslmi
阓	lslmo
闩	lsm
闰	lsmg
闬	lsmj
闫	lsmmm
阎	lsnhx
阚	lsnjk
阕	lsnok
闯	lsnvm
阄	lsnwu
闪	lso
阀	lsoi
闷	lsp
闱	lsqs
问	lsr
闾	lsrr
闻	lssj
阙	lstuo
闿	lsusu
阃	lswd	lsw'd
闸	lswl
阛	lswlv
闶	lsyhn
闵	lsyk
闼	lsyk
闹	lsylb
訚	lsymr
阏	lsysy
阂	lsyvo
儿	lu	c
鸩	lupym
邮	lwnl
电	lwu
补	ly
辈	lykq
裢	lykq
戬	mai
厩	maiu
亘	mam
雾	mbhes
丽	mbib
霭	mbivv
颥	mbmbo
雳	mbmks
郦	mbnl
页	mbo
贡	mbo
厕	mbon
鹂	mbpym
鹝	mbpym
鸸	mbpym
霁	mbykl
晋	mca
垩	mcg
恶	mcp
厢	mdbu
灭	mf
飘	mfhnk	mfhn'k
愿	mfp
瑷	mgbbe
现	mgbhu
珲	mgbkq
瑶	mgbou
璎	mgbov
琤	mgbsd
琐	mgfbo
珐	mggi
玑	mghn
瓒	mghuo
压	mgi
珑	mgikp
顼	mgmbo
环	mgmf
珏	mgmgi
琤	mgnsd
玛	mgnvm
玱	mgosu
玮	mgqs
琏	mgykq
琼	mgyrf
玙	mgysm
巩	mhni	mhn'i
鸦	mhpym
叆	mibbe
厌	mik
魇	miki
厣	mikl
厐	mikp
动	miks
餍	mikv
靥	mikw
叇	miyle
顸	mjmbo
蚕	mklmi
厍	mkq
历	mks
无	mku
丽	mmbib
项	mmbo
厅	mmn
鹉	mmpym
厉	mms
厨	mmti
厦	mmue
鼋	mmuu
亏	mmvs
殚	mncwj
歼	mnhj
殁	mnhne
残	mnij
殡	mnjoc
顶	mnmbo
殓	mnomm
殇	mnonh
殒	mnrbo
觋	mobhu
赝	mogo
豮	mojto
两	moob
鹀	mopym
碍	mrami
砚	mrbhu
碀	mrbsd
硚	mrhkl
矶	mrhn
矾	mrhni	mrhn'i
砜	mrhnk	mrhn'k
砾	mrhvd
矿	mri
碱	mrihr
碜	mrikh
硗	mrjpu
砗	mrkq
硖	mrkt
硕	mrmbo
砺	mrmms
碀	mrnsd
砀	mrnsh
码	mrnvm
硷	mromm
碛	mrqmo
砖	mrqni
礴	mrtei
硙	mrusu
础	mruu
励	msks
劢	msks
虿	mslmi
趸	msryo
开	mt
亚	mtc
严	mtch
顾	mumbo
顽	mumbo
鹴	mupym
画	muw	mu'w
顾	mvmbo
贾	mwbo
酿	mwiav
酦	mwive
酾	mwmbb
酝	mwmmi
酽	mwmth
觯	nbcwj
堕	nbg
奂	nbk
触	nblmi
负	nbo
觞	nbonh
鹬	nbpym
弹	ncwj
孙	ndf
剥	neln
卺	nemsu
尔	nf
玺	nfmgi
颋	ngmbo
骘	nhnvm
骛	nknvm
鹜	nkpym
阳	nla
陧	nlag
阴	nlb
陇	nlikp
陈	nlkd
阵	nlkq
陕	nlkt
际	nlmmf
陉	nlnom
隐	nlnsp
队	nlo
阶	nloll
险	nlomm
陦	nlqki
陆	nlqu
陨	nlrbo
随	nlykb
驲	nma
鲳	nmaa
鳁	nmabt
鲥	nmadi
鲫	nmail
鳀	nmamo
鲲	nmapp
鳎	nmasm
鲃	nmau
鳗	nmawe
鲷	nmbgr	nmb'gr
驵	nmbm
鲖	nmbmr	nmb'mr
鲗	nmbon
鳐	nmbou
鲏	nmdhe
驭	nme
骚	nmeii
鳋	nmeii
驿	nmeq
鲿	nmfbi
鳞	nmfdq
彛	nmfht
鲮	nmgce
鲑	nmgg
鲒	nmgr
鲌	nmha
鳈	nmhae
鳇	nmhag
稣	nmhd
鳅	nmhdf
鲦	nmhed
骆	nmher
骝	nmhhw
鳤	nmhjr
骄	nmhkl
鲘	nmhmr
鲧	nmhvf
骢	nmhwp
鲵	nmhxu
骏	nmice
骖	nmikh
鲹	nmikh
鱿	nmiku
鳙	nmilb
骀	nmir
鲐	nmir
鳡	nmirp
驴	nmis
骗	nmisb
鳊	nmisb
骟	nmism
鲓	nmjks
骔	nmjmf
鲩	nmjmu
驼	nmjp
鳍	nmjpa
骁	nmjpu
鲼	nmjto
驮	nmk
鲔	nmkb
驳	nmkk
骑	nmkmr
劲	nmks
鲣	nmleg
驶	nmlk
驯	nmlll
骕	nmlll
鳉	nmlmi
鲱	nmlmy
刭	nmln
骥	nmlpc
鲉	nmlw
骋	nmlws
骊	nmmbb
鲡	nmmbb
鲕	nmmbl	nmmb'l
颈	nmmbo
鳕	nmmbs
骦	nmmbu
录	nmme
鲆	nmmfj
鲠	nmmlk
鲄	nmmnr
鲾	nmmrw
鳜	nmmto
骠	nmmwf
鳔	nmmwf
鲺	nmnhi
鲬	nmnib
骉	nmnmm
骙	nmnok
驺	nmnsm	nmns'm
鳆	nmoae
驸	nmodi
鲋	nmodi
骓	nmog
鲶	nmoip
鲙	nmomi
验	nmomm
骅	nmopj
鲊	nmos
驰	nmpd
驹	nmpr
鲍	nmpru
鲽	nmptd
鲀	nmpu
鲭	nmqmb
鳄	nmrrs
骤	nmseo
鳚	nmsfi
鱽	nmsh
鲰	nmsje
驱	nmsk	nms'k
鲪	nmskr
鳛	nmsma
骎	nmsme
鲟	nmsmi
骣	nmsnd
鱾	nmsu
鳓	nmtjs
骐	nmtmc
鲯	nmtmc
鳠	nmtoe
鲜	nmtq
骈	nmtt
鳝	nmttr
鳟	nmtwi
鳢	nmtwt
鳒	nmtxc
鲻	nmvvw
驷	nmwc	nmw'c
骒	nmwd
鲤	nmwg
鲴	nmwjr	nmw'jr
骃	nmwk	nmw'k
鳏	nmwle
鳏	nmwlf
鳂	nmwmv
鳃	nmwp
骡	nmwvf
鳑	nmybs
鲛	nmyck
驻	nmyg
鲂	nmyhs
鲚	nmykl
鲢	nmykq
鲇	nmyr
鲸	nmyrf
骧	nmyrv
鲈	nmys
骍	nmytj
骇	nmyvo
鳣	nmywm
弥	nnf
预	nnmbo
弪	nnom
飞	no
坠	nog
张	npo
强	nrli
争	nsd
皱	nsdhe
刍	nsm	ns'm
邹	nsnl
雏	nsog
鸳	nupym
饣	nv
馄	nvapp
馒	nvawe
馉	nvbbb
馁	nvbv
馇	nvdam
馌	nvgit
饷	nvhbr	nvhb'r
饭	nvhe
饹	nvher
饪	nvhg
馏	nvhhw
饫	nvhk
饥	nvhn
饦	nvhp
饿	nvhqi
馊	nvhxe
馎	nvibi
馂	nvice
饯	nvij
饴	nvir
饽	nvjbd
馕	nvjbv
饶	nvjpu
馆	nvjrr
蚀	nvlmi
馈	nvlmo
饤	nvmn
饾	nvmrt
馅	nvnhx
饮	nvno
饧	nvnsh
馋	nvnuy
饬	nvoks
饰	nvolb
馀	nvomd
饩	nvomn
饸	nvomr
饱	nvpru
饨	nvpu
馔	nvruc
饵	nvsj
马	nvsm
饲	nvsmr
馍	nvtak
馓	nvtbk
馑	nvtlm
馐	nvtqg
饼	nvtt
饳	nvuu
馃	nvwd
饺	nvyck
饻	nvyhv
鱼	nwm
鲁	nwma
龟	nwu
鹐	nxpym
买	nyk
复	oahe
内	ob
伣	obhu
侧	obon
叙	ode
体	odm
鸺	odpm
仅	oe
傩	oeog
偿	ofbi
傥	ofbu
籴	ofd
偻	ofdv
伞	ofj
鹪	ofpym
赁	ogbo
凭	oghn
雠	ogivg
隽	ognhs
鹤	ogpym
侬	ohbv
侨	ohkl
仪	oik
伪	oiks
优	oiku
刽	oiln
领	oimbo
邻	oinl
郐	oinl
贪	oino
鸰	oipym
储	oiva
傤	ojiq
伫	ojm
傧	ojoc
侥	ojpu
偾	ojto
矫	okhkl
鳘	oknwm
伡	okq
侠	okt
个	ol
们	olis
俪	ombb
佥	omfm
剑	omln
会	ommi
畲	ommw
气	omn
俩	omob
敛	omok
钅	omp
俨	omth
亿	on
氲	onabt
觎	onbhu
氩	onmtc
氢	onnom
从	oo
伤	ooks
价	ooll
丛	oom
侩	oomi
俭	oomm
众	ooo
伦	oop
怂	oop
耸	oosj
伧	oosu
仑	op
锠	opaa
镅	opahu
钽	opam
锝	opami
锡	opaph
锟	opapp
钯	opau
银	opav
镘	opawe
钥	opb
锊	opbdi
钢	opbk	opb'k
锾	opbme
铜	opbmr	opb'mr
锄	opbms
货	opbo
贷	opbo
钡	opbo
铡	opbon
钼	opbu
锑	opcnh
锐	opcru
铍	opdhe
钵	opdm
铼	opdt
钗	opei	opei
钗	opei	ope'i
铴	openh
铎	opeq
钬	opf
销	opfb
镗	opfbg
锁	opfbo
镋	opfbu
镂	opfdv
锬	opff
钞	opfh
锩	opfqu
铛	opfsm	opfs'm
钍	opg
铂	opha
锦	ophab
锽	ophag
锹	ophdf
锈	ophds
钣	ophe
锋	ophej
铬	opher
铥	ophgi
锆	ophgr
铣	ophgu
钐	ophhh
铆	ophhl
镏	ophhw
钎	ophj
铢	ophjd
锻	ophje
锺	ophjg
锤	ophjm
锧	ophjo
铦	ophjr
锸	ophjx
锨	ophlo
钒	ophni	ophn'i
铅	ophnr
锇	ophqi
铁	ophqo
镍	ophud
铄	ophvd
锼	ophxe
锒	opiav
镈	opibi
铖	opihs
钱	opij
铺	opijb
钹	opike
镛	opilb
镳	opipf
铽	opipp
镰	opitc
镀	opite
钺	opiv
华	opj
针	opj
镇	opjbc
镲	opjbf
镩	opjcl
镕	opjcr
锗	opjka
铑	opjkp
铐	opjks
锭	opjmo
镓	opjmo
镔	opjoc
铊	opjp
铙	opjpu
钴	opjr
铵	opjv
铕	opkb
镣	opkcf
铩	opkd
钛	opki
锛	opkjt
钸	opklb
锜	opkmr
偬	opkp
铗	opkt
钟	opl
铿	opleg
钔	oplis
钏	oplll
锵	oplmi
铫	oplmo
钊	opln
镄	oplno
锏	oplsa
锎	oplst
镧	oplsw
铀	oplw
镭	opmbw
钚	opmf
钰	opmgi
铘	opmhl
铚	opmig
铻	opmmr
钉	opmn
钶	opmnr
倾	opmo
镉	opmrb
钘	opmt
铔	opmtc
铏	opmtn
镢	opmto
镖	opmwf
镡	opmwj
钲	opmym
钙	opmys
钇	opn
铯	opnau
锰	opndt
钮	opng
钑	opnhe
铭	opnir
铤	opnkg
键	opnkq
锕	opnlr
钌	opnn
钦	opno
镫	opnot
镵	opnri
镪	opnri
铮	opnsd
钖	opnsh
镥	opnwa
伥	opo
钠	opob
锥	opog
镌	opogs
铃	opoii
钤	opoin
铨	opomg
铪	opomr
锉	opoog
铧	opopj
镎	oporq
铋	opph
锪	opphp
钓	oppi
钩	oppi
钧	oppim
锴	opppa
铇	oppru
钝	oppu
钨	oppvm
锲	opqhk
铸	opqki
锖	opqmb
铞	oprlb
锃	oprmg
锅	oprob
铝	oprr
锷	oprrs
铒	opsj
镊	opsje
锯	opsjr
锓	opsme
镠	opsmh
铌	opsp
钷	opsr	ops'r
钜	opss
锔	opssr	opss'r
错	opta
镆	optak
铹	optbs
镨	optca
镤	optco
镒	optct
镁	optgk
锘	optkr
锳	optlk
钳	optm	opt'm
镬	optoe
镃	optvi
锚	optw
铓	optyv
钆	opu
镚	opubb
铠	opusu
钕	opv
铷	opvr
镴	opvvv
锱	opvvw
钿	opw
锞	opwd
锂	opwg
锢	opwjr	opw'jr
铟	opwk	opw'k
钾	opwl
镯	opwli
锣	opwln
镮	opwlv
锶	opwp
镙	opwvf
钋	opy
镑	opybs
镝	opycb
铰	opyck
镦	opydk
钪	opyhn
钫	opyhs
铱	opyhv
锍	opyiu
铳	opyiu
钭	opyj
链	opykq
铈	opylb
钻	opyr
镐	opyrb
镶	opyrv
锿	opyrv
镞	opysk
镟	opyso
铲	opyth
锌	opytj
镱	opytp
锫	opytr
镜	opytu
铉	opyvi
俦	oqki
债	oqmo
传	oqni
伟	oqs
龛	orikp
颔	ormbo
颌	ormbo
俣	ormk
鸽	orpym
侣	orr
伛	osk
侭	osoy
仓	osu
戗	oui
创	ouln
鸧	oupym
侦	oybo
侪	oykl
愠	pabt
恽	pbkq
惧	pbmc
恻	pbon
悦	pcru
惮	pcwj
懒	pdlo
颖	pdmbo
颍	pembo
怿	peq
颕	pfmbo
颎	pfmbo
忏	phj
惨	pikh
忧	piku
匀	pim
鸨	pjpym
愤	pjto
惭	pkql
悭	pleg
愦	plmo
悯	plsk
顷	pmbo
怀	pmf
恹	pmik
恸	pmis
鸵	pmjp
怃	pmku
邬	pmnl
鹱	pmtoe
忆	pn
长	po
怜	poii
勚	poks
忾	pomn
怆	posu
毕	ppj
毙	ppmnp
怅	ppo
够	prnin
鸲	prpym
慑	psje
怄	psk	ps'k
惬	pskt	ps'kt
贳	ptbo
顿	pumbo
恺	pusu
乌	pvsm
惯	pwjo
惊	pyrf
枭	pysd
鸟	pysm
凫	pysn
岛	pysu
袅	pysv
恼	pyuk
懔	pywf
揾	qabt
担	qam
靓	qbbhu
挥	qbkq
静	qbnsd
摇	qbou
撄	qbov
拥	qbq	qb'q
掸	qcwj
耧	qdfdv
摊	qeog
择	qeq
麸	qeqo
撑	qfbq
搅	qfbu
搂	qfdv
挡	qfsm	qfs'm
擞	qfvk
挂	qgg
撷	qgro
挢	qhkl
攒	qhuo
扩	qi
贽	qibo
热	qif
焘	qif
垫	qig
掺	qikh
拢	qikp
势	qiks
扰	qiku
蛰	qilmi
鸷	qipym
挚	qiq
护	qis
拨	qive
絷	qivif
撺	qjcl
拧	qjmn
艳	qjnau
摈	qjoc
挠	qjpu
赘	qkbo
寿	qkdi
执	qkni
抛	qkns
骜	qknvm
鳌	qknwm
挟	qkt
拣	qkvc
拣	qkvd
扪	qlis
揽	qliu
帮	qllb
搁	qlsr
责	qmbo
麦	qme
抚	qmku
夀	qmrdi
换	qnbk
专	qni
挣	qnsd
扬	qnsh
搀	qnuy
撸	qnwa
规	qobhu
携	qogs
辇	qokq
捡	qomm
抡	qop
揿	qopo
抢	qosu
捣	qpyu
抟	qqni
撵	qqoq
损	qrbo
韦	qs
韫	qsabt
韬	qsbhx
韨	qsike
摄	qsje
抠	qsk	qs'k
报	qsle
扫	qsm	qs'm
挦	qsmi
韧	qsshi
捞	qtbs
掷	qtkl
拦	qtmm
击	qu
椝	qud
鬶	qumrb
拟	qvio
掼	qwjo
摆	qwli
掴	qwmi	qw'mi
扑	qy
搒	qybs
挝	qydi
挞	qyk
挤	qykl
摅	qypp
掳	qyps
嗳	rbbe
剐	rbln
员	rbo
呗	rbo
嘤	rbov
鹃	rbpym
啴	rcwj
叹	re
唢	rfbo
喽	rfdv
响	rhbr	rhb'r
哝	rhbv
听	rhml
叽	rhn
咙	rikp
咏	rine
咛	rjmn
哓	rjpu
喷	rjto
啭	rkqi
啸	rlll
虽	rlmi
黾	rlwu
唝	rmbo
啀	rmgg
踬	rmhjo
跃	rmhk
躜	rmhuo
跞	rmhvd
践	rmij
蹿	rmjcl
踪	rmjmf
跷	rmjpu
吴	rmk
呖	rmks
呒	rmku
蹰	rmmmi
踭	rmnsd
跄	rmosu
跸	rmppj
踌	rmqki
蹑	rmsje
哑	rmtc
踯	rmtkl
躏	rmtlg
蹒	rmtmb
号	rmvs
吓	rmy
跹	rmyhj
跶	rmyk
跻	rmykl
唤	rnbk
吗	rnvm
噜	rnwa
呐	rob
呙	rob
勋	roks
哙	romi
郧	ronl
哗	ropj
呛	rosu
吣	rp
哔	rppj
吨	rpu
呜	rpvm
鸣	rpym
唛	rqme
啧	rqmo
吕	rr
嚣	rrmor
骂	rrnvm
鹭	rrpym
鼍	rrwmu
嘱	rshb
嗫	rsje
呕	rsk	rs'k
别	rsln
颚	rsmbo
鹗	rspym
鸮	rspym
唠	rtbs
呓	rtn
导	rudi
哕	runi	run'i
异	rut
哟	rvmi
咝	rvvm
啰	rwln
啯	rwmi	rw'mi
哒	ryk
哜	rykl
啮	rymu
嘘	rypc
屃	sbo
颞	sembo
鹥	sepym
屡	sfdv
駆	sfsk
鬇	shbsd
鬓	shjoc
属	shlb
鬇	shnsd
屦	shov
鹨	shpym
习	sim
聪	sjcrp
聂	sjee
聍	sjjmn
聩	sjlmo
职	sjrc
联	sjtk
耻	sjylm
区	sk	s'k
鴎	skhaf
殴	skhne
瓯	skmvn
欧	skno
鸥	skpym
匦	skqn	s'kqn
卫	slm
颐	slmbo
匮	slmo	s'lmo
赜	slqmo
届	slw
卧	sly
翚	smbkq
寻	smdi
灵	smf
彛	smfht
层	smmi
昼	soam
医	sok	s'ok
尽	soy
屉	spt
鸤	spym
剧	srln
异	sut
莳	tadi
蓦	takm
鹊	tapym
觏	tbbhu
蓥	tbc
荣	tbd
荥	tbe
荧	tbf
茔	tbg
荦	tbhq
苋	tbhu
荤	tbkq
劳	tbks
萤	tbli
颟	tbmbo
莹	tbmi
茕	tbnj
荝	tbon
莺	tbpm
营	tbrr
萦	tbvf
业	tc
觍	tcbhu
蕲	tcjl
邺	tcnl
鹣	tcpym
凿	tcuj	tcu'j
莱	tdt
荡	tenh
蒌	tfdv
薮	tfvk
盖	tgbt
蔷	tgcw
羡	tgimo
颧	tgmbo
鹳	tgpym
荞	thkl
芦	ths
蒇	tiho
茏	tikp
薬	tiod
鹚	tipym
芦	tis
蔼	tivv
带	tjblb
蘖	tjd
荆	tjln
苎	tjm
荛	tjpu
鞯	tjtkd
鞑	tjyk
关	tk
获	tkhk
莸	tkhu
荐	tkld
郑	tknl
苏	tksc
荚	tkt
蓝	tlit
萧	tlll
荘	tlmg
蒋	tlmi
茧	tlmi
蒉	tlmo
蔺	tlsg
黄	tlwc
觐	tmbhu
苈	tmks
芜	tmku
兰	tmm
艺	tn
荪	tndf
荫	tnlb
萨	tnlh
蓟	tnmn
藓	tnmq
蓣	tnno
茎	tnom
养	toll
荟	tomi
蔹	tomk
莶	tomm
苁	too
芲	top
鹲	topym
苍	tosu
莅	toyt
葱	tpkp
苌	tpo
荜	tppj
茑	tpym
芈	tq
着	tqbu
羟	tqnom
鲝	tqnwm
苇	tqs
莴	trob
节	tsl
荨	tsmi
荩	tsoy
并	tt
荆	ttln
鹢	ttpym
兹	tvii
药	tvmi
荮	tvmi
荭	tvmm
蕴	tvmt
莼	tvmu
芗	tvvh
萝	twln
鹋	twpym
荠	tykl
莲	tykq
蓠	tyub
岘	ubhu
岗	ubk	ub'k
颛	ubmbo
崃	udt
峄	ueq
嵝	ufdv
峤	uhkl
岚	uhnk	uhn'k
巅	ujco
岽	ukd
崭	ukql
峡	ukt
岿	ulls
岁	uni
刿	unln
峥	unsd
岭	uoii
崄	uomm
嵚	uopo
岖	usk	us'k
岂	usu
嵘	utbd
崂	utbs
敳	utok
觊	uubhu
粜	uufd
凯	uuhn
剀	uuln
屿	uysm
媪	vabt
嫒	vbbe
姗	vbbm
婙	vbsd
婵	vcwj
断	vdhml
驽	venvm
嫱	vgcw
娇	vhkl
飨	vhoiv
幺	vi
嬷	vidi
妫	viks
姹	vjhp
婶	vjll
嫔	vjoc
娆	vjpu
娴	vlsd
缊	vmabt
缇	vmamo
绲	vmapp
缦	vmawe
绷	vmbb
绶	vmbbe
绸	vmbgr	vmb'gr
纲	vmbk	vmb'k
组	vmbm
缓	vmbme
缨	vmbov
缈	vmbuh
绥	vmbv
绨	vmcnh
绤	vmcor
纷	vmcsh
缯	vmcwa
缃	vmdbu
纣	vmdi
缀	vmeee
绎	vmeq
绡	vmfb
绱	vmfbr	vmfb'r
缕	vmfdv
彝	vmfft
纱	vmfh
彜	vmfht
绊	vmfq
绻	vmfqu
绫	vmgce
结	vmgr
缬	vmgro
绵	vmhab
缐	vmhae
绣	vmhds
绦	vmhed
绛	vmheq
络	vmher
终	vmhey
纴	vmhg
纤	vmhj
缎	vmhje
缍	vmhjm
绗	vmhon
缴	vmhsk
缵	vmhuo
纸	vmhvp
绺	vmhyr
纩	vmi
缚	vmibi
缄	vmihr
线	vmij
绒	vmij
绂	vmike
绐	vmir
编	vmisb
缠	vmiwg
缜	vmjbc
绪	vmjka
纻	vmjm
综	vmjmf
绽	vmjmo
续	vmjnk
缩	vmjoa
缤	vmjoc
绕	vmjpu
绾	vmjrr
缭	vmkcf
纮	vmki
绮	vmkmr
绔	vmkms
纨	vmkni
妩	vmku
练	vmkvc
练	vmkvd
缆	vmliu
绋	vmlln
缋	vmlmo
绯	vmlmy
绅	vmlwl
红	vmm
缙	vmmca
纡	vmmd
绖	vmmig
绠	vmmlk
纭	vmmmi
缛	vmmvi
缥	vmmwf
缅	vmmwl	vmmw'l
缰	vmmwm
绝	vmnau
纽	vmng
级	vmnhe
纾	vmnin
纼	vmnl
绿	vmnme
经	vmnom
绉	vmnsm	vmns'm
纳	vmob
维	vmog
绘	vmomi
缏	vmomk
给	vmomr
纥	vmon
缑	vmonk
纵	vmoo
纶	vmop
绚	vmpa
约	vmpi
绹	vmpou
纰	vmpp
绁	vmpt
纯	vmpu
绑	vmqjl
绩	vmqmo
纬	vmqs
辔	vmr
绢	vmrb
织	vmrc
绳	vmrlu
缗	vmrpa
缲	vmrrd
缉	vmrsj
纫	vmshi
绍	vmshr
缪	vmsmh
纪	vmsu
娅	vmtc
缢	vmtct
缂	vmtlj
绬	vmtlk
绀	vmtm	vmt'm
缮	vmttr
缣	vmtxc
绌	vmuu
继	vmvfd
纠	vmvl
缘	vmvno
缫	vmvvd
缁	vmvvw
细	vmw
缳	vmwlv
缌	vmwp
缧	vmwvf
绰	vmyaj
缔	vmybb
绞	vmyck
缝	vmyhj
缒	vmyhr
纺	vmyhs
统	vmyiu
纹	vmyk
缱	vmylr
缟	vmyrb
缡	vmyub
缞	vmywv
婙	vnsd
妈	vnvm
娱	vrmk
娲	vrob
妪	vsk	vs'k
妇	vsm	vs'm
乡	vvh
丝	vvm
纟	vvm
鸶	vvmpm
颙	wbmbo
团	wdh	w'dh
颗	wdmbo
黪	wfikh
黩	wfjnk
图	whey	w'hey
贯	wjbo
罢	wlgi
罴	wlgif
罚	wlivn
罗	wlni	wln'i
鸭	wlpym
羁	wltjm
国	wmgi	w'mgi
园	wmmu	w'mmu
囵	wop	w'op
畴	wqki
围	wqs	w'qs
圆	wrbo	w'rbo
鹮	wvpym
韵	yapim
贞	ybo
遥	ybou
觑	ycbhu
銮	ycc
栾	ycd
变	yce
兖	ycihu
衮	ycihv
蛮	yclmi
弯	ycn
孪	ycnd
递	ycnh
脔	ycobo	ycob'o
恋	ycp
鸾	ycpym
挛	ycq
峦	ycu
娈	ycv
亸	ydcwj
过	ydi
鹑	ydpym
广	yh	i
选	yhgu
彦	yhhhh
迁	yhj
频	yhmbo
颜	yhmbo
弃	yit
赣	yjheo
辩	yjivj
辫	yjvmj
头	yk
达	yk
齐	ykll
齑	yklll
刘	ykln
斓	yklsw
斋	ykmbl	ykmb'l
连	ykq
边	yks
剂	ylln
遗	ylmo
逦	ymbb
赟	ymbo
还	ymf
颤	ymmbo
运	ymmi
远	ymmu
欤	ymno
鹯	ympym
迈	yms
齿	ymuo	ymu'o
赢	ynbo
逊	yndf
迩	ynf
颃	ynmbo
辽	ynn
迳	ynom
颦	yohwj
颏	yombo
戆	yop
赀	ypbo
虏	ypks
虑	ypp
虚	yptc
亵	yqiv
违	yqs
觇	yrbhu
諍	yrbsd
点	yrf
战	yri
諍	yrnsd
卢	ys
与	ysm
颅	ysmbo
迟	yso
鸬	yspym
竫	ytbsd
亲	ytd
产	yth
飒	ythnk	ythn'k
竫	ytnsd
竞	ytrhu
进	ytt
龈	yuav
龃	yubm
龋	yuhlb
龂	yuhml
龉	yummr
龄	yuoii
龁	yuon
龀	yup
龅	yupru
鹫	yupym
龊	yuryo
龆	yushr
龌	yusmg
龇	yuymp
亩	yw
卤	ywk	yw'k
逻	ywln
禀	ywrf
鹾	ywtqm
这	yyk
暧	xabbe
晖	xabkq
脱	xbcru
贱	xboij
瞆	xbulm
觃	xbund
兑	xcrhu
栀	xdhmu
桡	xdjpu
橱	xdmmi
椭	xdnlb
橹	xdnwa
枞	xdoo
构	xdpi
赉	xdtbo
懑	xebp
双	xee
烫	xehf
溃	xelmo
洒	xemcw
涣	xenbk
澛	xenwa
溆	xeode
涩	xesim
浔	xesmi
滚	xeycv
滤	xeypp
鸴	xfbpy
挙	xfcq
娄	xfdv
尘	xfg
焕	xfnbk
壳	xgbhn
壸	xgbmc
圹	xgi
埩	xgnsd
奥	xhbk
税	xhdcr
穞	xhdnw
处	xhey
鸱	xhipy
篑	xhlmo
飓	xhnbm
飚	xhnff
飗	xhnhh
飕	xhnhx
飑	xhnpr
飔	xhnwp
飐	xhnyr
敌	xhrok
鸹	xhrpy
启	xhsr
氇	xhunw
粤	xhwmv
术	xid
毵	xihhq
庐	xihs
戋	xij
义	xik
楽	xiod
垄	xipg
讹	xivop
诣	xivpa
窥	xjcqo
宽	xjtbu
杀	xkd
刹	xkdln
癞	xkdlo
狲	xkhnd
瘪	xkhup
堑	xklg
疴	xkmnr
痪	xknbk
瘾	xknlp
蚬	xlibh
蛊	xlibt
蜕	xlicr
丬	xlim
闼	xlsyk
裢	xlykq
戬	xmai
郦	xmbnl
贡	xmbo
鹝	xmbpy
灭	xmf
瑷	xmgbb
瑶	xmgbo
压	xmgi
叆	xmibb
叇	xmiyl
厍	xmkq
历	xmks
鼋	xmmuu
亏	xmmvs
歼	xmnhj
劢	xmsks
顽	xmumb
酾	xmwmb
奂	xnbk
随	xnlyk
鳋	xnmei
鲹	xnmik
鲐	xnmir
鳊	xnmis
骕	xnmll
鳉	xnmlm
鲡	xnmmb
鳔	xnmmw
鲋	xnmod
鱾	xnmsu
鲯	xnmtm
坠	xnog
内	xob
伣	xobhu
仪	xoik
郐	xoinl
贪	xoino
个	xol
俪	xombb
气	xomn
亿	xon
怂	xoop
仑	xop
贷	xopbo
钍	xopg
针	xopj
镓	xopjm
镪	xopnr
钩	xoppi
铱	xopyh
铳	xopyi
锿	xopyr
颌	xormb
伛	xosk
悦	xpcru
颎	xpfmb
忾	xpomn
贳	xptbo
摇	xqbou
攒	xqhuo
扩	xqi
焘	xqif
换	xqnbk
撸	xqnwa
挦	xqsmi
掷	xqtkl
椝	xqud
鬶	xqumr
挞	xqyk
摅	xqypp
掳	xqyps
嗳	xrbbe
呗	xrbo
啀	xrmgg
踭	xrmns
蹑	xrmsj
踯	xrmtk
唤	xrnbk
噜	xrnwa
呐	xrob
吣	xrp
鼍	xrrwm
别	xrsln
鸮	xrspy
哒	xryk
啮	xrymu
屦	xshov
蓥	xtbc
荣	xtbd
茔	xtbg
业	xtc
荛	xtjpu
郑	xtknl
茧	xtlmi
苈	xtmks
荪	xtndf
莶	xtomm
芲	xtop
芈	xtq
荨	xtsmi
并	xtt
萝	xtwln
嫒	xvbbe
妫	xviks
绷	xvmbb
绡	xvmfb
绒	xvmij
辔	xvmr
纟	xvvm
庆	xxik
鸸	xxmbp
堕	xxnbg
飞	xxno
钡	xxopb
钆	xxopu
呙	xxrob
荮	xxxtv
达	xxyk
遥	xybou
颜	xyhmb
头	xyk
遗	xylmo
欤	xymno
逊	xyndf
点	xyrf
龈	xyuav
龃	xyubm
龋	xyuhl
龂	xyuhm
龉	xyumm
龄	xyuoi
龁	xyuon
龀	xyup
龅	xyupr
龊	xyury
龆	xyush
龌	xyusm
龇	xyuym
鹾	xywtq
㬇	anbk
䦛	annsd
㬹	bbsd
䝲	bcsoy
䲢	bfqm
䝙	bhsk
䴗	bkpym
㬹	bnsd
䞎	boaa
䞌	bohjr
䞐	boqka
䞍	boqmb
䞏	bowp
䏝	bqni
䁖	bufdv
㭎	dbk
㭣	dlsr
㭥	dnbo
㭤	dpym
㭏	dqs
㶉	ebkm
㶽	frob
䅪	hdlmo
䅋	hdnau
䠺	hhlsr
䇲	hkt
䴘	hnpym
㹑	hqipc
㓆	imop
䶭	ipmg
䶮	ipmk
䜣	ivhml
䜨	ivllp
䜥	ivnkm
䜧	ivsim
䜤	ivtc
䜩	ivtlf
䜦	ivtpa
㝉	jm
㝍	jysm
㺆	khiko
㺙	khjwo
䢁	kqb
䢀	kqon
䢂	kqyt
㡈	lbnau
䙌	llmo
䘞	lnvm
䣒	lonl
䦶	lsnsd
䦷	lsoog
䦸	lswlb
䴓	mbpym
㱮	mnlmo
䴕	mnpym
䃅	mrcwj
䂵	mrmbo
䩄	mwbhu
䱢	nfnsd
䲟	nmhpl
䯃	nmjv
䲝	nmosu
䲠	nmqka
䯄	nmrob
䯅	nmsje
䲡	nmtcw
䲞	nmyt
䭪	nvamg
㐽	ohnk
㑈	okd
㑔	ombo
㐷	onvm
䦆	opbue
䥾	opbym
䥿	ophms
䦂	ophsm
䦂	opism
䥽	opive
䦄	opjiv
䥻	opmku
䥺	opmvh
䥼	opphh
䦁	opqjl
䦀	opsmm
䦃	optja
䦅	opttr
㑩	owln
㥪	pfdv
㦐	pipc
㤽	pqki
㧏	qbk
䴖	qbpym
㧑	qiki
㗷	rjto
㘎	rlsk
㖞	rrob
䴙	sryjm
䓓	tqki
䍵	tqnsd
㟆	uopj
䋄	vfbk
䋫	vfnsd
㚯	vhnk
㛠	vlsa
䌽	vmbd
䌹	vmbr
䌼	vmcru
䌶	vmdh
䌾	vmjbj
䍀	vmlit
䌷	vmlw
䌿	vmmrw
䌸	vmqni
䌺	vmsj
䌻	vmsmm
䍁	vmyto
㛟	vnbk
㛣	vrbo
㪱	yknbk
䴔	ykpym
䲣	ymok
